0111222222
0111233233
1111111111
1111100000
1111111111
1111111110
1110000001
0111222222
0111233233
1111111111
0111233233