0111222222222211111111100000022211111111
0111233233322311111111100000022211111111
1111111111133311111111100000022211111111
1111100000022211111111100000022211111111
1111111111112222211111100000022211111111
1111111110001111111111100000022211111111
1110000001111111111111100000022211111111
0111222222222211111111100000022211111111
0111233233322311111111100000022211111111
1111111111133311111111100000022211111111
1111100000022211111111100000022211111111
1111111111112222211111100000022211111111
1111111110001111111111100000022211111111
1110000001111111111111100000022211111111
0111222222222211111111100000022211111111
0111233233322311111111100000022211111111
1111111111133311111111100000022211111111
1111100000022211111111100000022211111111
1111111111112222211111100000022211111111
1111111110001111111111100000022211111111
1110000001111111111111100000022211111111
